2333333333333333333333334
2010000100010000000010004
2000010000100010001000104
2000010000100010000001004
2000001000001000001001004
2000011000010001010101014
2000010000001000010001004
2000011000001000100010014
2000010010001000001001004
2100001000100000101000004
2010001000000101000000104
2100001000001010000010004
2100001000001000100010004
2100001000100010000010004
2100001000100010000010004
2100001000100010000010004
2333333333333333333333334
-
0,2,2