2333333333333333333333334
2010000100010000000010004
2000010050100010501000104
2000010050100010500001004
2000001050001000501001004
2000011050010001510101014
2000010050001000510001004
2000011050001000500010014
2066666656666666566666604
2100001050100000501000004
2010001050000101500000104
2100001050001010500010004
2100001050001000500010004
2100001050100010500010004
2100001050100010500010004
2100001000100010000010004
2333333333333333333333334
-
11,12,14